{
  "mapInitState": {
    "board" : {
      "map" : [[0, 94, 93, 93, 93, 93, 93, 94],
      [0, 94, 93, 93, 93, 93, 93, 94],
      [0, 94, 93, 93, 93, 93, 93, 94],
      [0, 94, 93, 93, 93, 93, 0, 94],
      [0, 0, 0, 93, 90, 93, 0, 0],
      [0, 92, 0, 0, 0, 0, 0, 0],
      [94, 94, 94, 94, 94, 94, 0, 94],
      [0, 0, 0, 95, 0, 0, 0, 0]],
      "torchPos" : { "x" : -1, "y" : -1},
      "bombPos" : {"x" : -1, "y" : -1},
      "bombArea" : []
    },
    "character" : {
      "pos" : { "x" : 7, "y" : 0},
      "dir" : 2,
      "items" : {
        "torchNum" : 0,
        "bombNum" : 1
      }
    },
    "enemy" : []
  },
  "mapResource": {
    "width": 8,
    "height": 8,
    "id": [
            0, 1, 2, 3, 1, 2, 1, 4,
            16, 50, 50, 50, 50, 50, 50, 36,
            48, 50, 50, 50, 50, 50, 50, 52,
            32, 50, 50, 50, 50, 50, 50, 52,
            32, 50, 50, 50, 50, 50, 50, 52,
            32, 50, 50, 50, 50, 50, 50, 36,
            48, 50, 50, 50, 50, 50, 50, 52,
            64, 67, 67, 65, 67, 65, 67, 68
          ],
    "id_t": [
              183, 95, 176, 177, 178, 179, 180, 95,
              183, 95, 192, 193, 194, 195, 196, 95,
              183, 95, 208, 214, 210, 211, 212, 95,
              183, 95, 183, 199, 200, 201, 183, 95,
              183, 183, 183, 215, 216, 217, 183, 183,
              183, 115, 183, 183, 131, 183, 183, 183,
              77, 110, 110, 110, 110, 110, 130, 111,
              183, 183, 183, 114, 183, 183, 183, 183
            ]
  },
  "blocklyConfig": {
    "initialXml": "<xml xmlns='http://www.w3.org/1999/xhtml'><block type='actions_go' x='10' y='40'></block></xml>"
  },
  "savedSolution":"",
  "stdBlockNum": 10
}
