{
	"mapInitState": {
	  "board" : {
		"map" : [[0, 0, 0, 0, 0, 2, 2, 2],
		[0, 0, 0, 0, 0, 2, 0, 2],
		[0, 0, 2, 0, 0, 2, 0, 2],
		[0, 0, 0, 0, 0, 0, 0, 0],
		[0, 2, 0, 0, 0, 2, 2, 0],
		[0, 0, 2, 2, 2, 0, 0, 0],
		[0, 2, 2, 2, 0, 0, 1, 0],
		[0, 2, 2, 2, 0, 0, 0, 0]]
	  },
	  "character" : {
		"pos" : { "x" : 2, "y" : 3},
		"dir" : 2
	  }
	},
	"mapResource": {
	  "width": 8,
	  "height": 8,
	  "id": [ 
			  0, 1, 2, 3, 4, 7, 8, 9,
			  16, 50, 50, 50, 20, 23, 24, 25,
			  32, 50, 50, 50, 36, 23, 24, 25,
			  48, 49, 50, 51, 52, 23, 24, 25,
			  64, 65, 66, 67, 68, 39, 40, 41,
			  7, 8, 8, 8, 8, 8, 8, 9,
			  23, 24, 24, 24, 24, 24, 24, 25,
			  39, 40, 40, 40, 40, 40, 40, 41
			],
	  "id_t": [
				183, 183, 183, 183, 183, 77, 110, 79, 
				183, 183, 183, 183, 183, 93, 183, 95, 
				183, 183, 115, 183, 183, 63, 183, 95, 
				183, 183, 183, 183, 183, 183, 183, 130, 
				183, 115, 183, 34, 183, 109, 111, 183, 
				183, 183, 109, 110, 111, 244, 183, 183, 
				183, 229, 230, 231, 183, 183, 114, 183, 
				183, 245, 246, 247, 183, 183, 183, 183
			  ]
	},
	"blocklyConfig": {
	  "initialXml": "<xml xmlns='http://www.w3.org/1999/xhtml'><block type='actions_go' x='10' y='40'></block></xml>"
	}
  }