{
    "mapInitState": {
      "board" : {
        "map" : [[0, 0, 0, 0, 0, 0, 0, 0],
        [0, 0, 0, 0, 0, 0, 0, 0],
        [0, 0, 0, 0, 0, 0, 0, 0],
        [0, 0, 0, 0, 0, 0, 0, 0],
        [0, 0, 0, 0, 0, 0, 0, 0],
        [0, 0, 0, 0, 0, 0, 0, 0],
        [0, 0, 0, 0, 0, 0, 0, 0],
        [0, 0, 0, 0, 0, 0, 0, 0]]
      },
      "character" : {
        "pos" : { "x" : 4, "y" : 4},
        "dir" : 2
      }
    },
    "mapResource": {
      "width": 8,
      "height": 8,
      "id": [ 
            7, 8, 8, 8, 8, 8, 8, 9,
            23, 24, 24, 24, 24, 24, 24, 25,
            39, 40, 40, 40, 40, 40, 40, 41,
            144, 145, 86, 87, 87, 88, 120, 121,
            144, 145, 102, 103, 103, 104, 136, 137,
            69, 8, 8, 8, 69, 69, 69, 69
            ],
      "id_t": [
        183, 183, 183, 183, 183, 77, 110, 79, 
        183, 183, 183, 183, 183, 93, 183, 95, 
        183, 183, 115, 183, 183, 63, 183, 95, 
        183, 183, 183, 183, 183, 183, 183, 130, 
        183, 183, 183, 34, 183, 183, 183, 183, 
        183, 183, 109, 110, 111, 244, 183, 183, 
        183, 229, 230, 231, 183, 183, 114, 183, 
        183, 245, 246, 247, 183, 183, 183, 183
              ]
    },
    "blocklyConfig": {
      "initialXml": "<xml xmlns='http://www.w3.org/1999/xhtml'><block type='go' x='10' y='40'></block></xml>"
    }
  }