{
    "mapInitState": {
      "board" : {
        "map" : [[0, 0, 0, 0, 0, 0, 0, 0],
        [0, 0, 0, 0, 0, 0, 0, 0],
        [0, 0, 0, 0, 0, 0, 0, 0],
        [0, 0, 0, 0, 0, 0, 0, 0],
        [0, 0, 0, 0, 0, 0, 0, 0],
        [0, 0, 0, 0, 0, 0, 0, 0],
        [0, 0, 0, 0, 0, 0, 0, 0],
        [0, 0, 0, 0, 0, 0, 0, 0]]
      },
      "character" : {
        "pos" : { "x" : 1, "y" : 1},
        "dir" : 2
      },
      "enemy" :["enemy1"],
      "enemy1" : {
        "pos" : { "x" : 3, "y" : 2},
        "dir" : 1,
        "isAlive" : true,
        "turningPoint" : [
          {
            "pos" : { "x" : 3, "y" : 3},
            "dir" : 2
          },
          {
            "pos" : { "x" : 4, "y" : 3},
            "dir" : 3
          },
          {
            "pos" : { "x" : 4, "y" : 2},
            "dir" : 0
          },
          {
            "pos" : { "x" : 3, "y" : 2},
            "dir" : 1
          }
        ]
      }
    },
    "mapResource": {
      "width": 8,
      "height": 8,
      "id": [ 
              0, 1, 2, 3, 1, 2, 1, 4,
              16, 5, 6, 10, 11, 12, 13, 20,
              32, 21, 22, 26, 28, 156, 45, 36,
              48, 49, 50, 26, 14, 15, 45, 52,
              48, 51, 50, 26, 30, 31, 45, 52,
              48, 49, 50, 58, 59, 59, 61, 52,
              16, 50, 50, 50, 49, 50, 50, 52,
              64, 65, 66, 67, 67, 65, 65, 68
            ],
      "id_t": [
                183, 183, 183, 183, 183, 183, 183, 183, 
                183, 183, 183, 183, 183, 183, 183, 183, 
                183, 183, 183, 183, 183, 183, 183, 183, 
                183, 183, 34, 183, 183, 183, 183, 130, 
                183, 183, 183, 183, 183, 183, 183, 183, 
                183, 183, 183, 183, 183, 183, 183, 183, 
                183, 183, 228, 183, 183, 183, 114, 183, 
                183, 183, 183, 183, 183, 183, 183, 183
              ]
    },
    "blocklyConfig": {
      "initialXml": "<xml xmlns='http://www.w3.org/1999/xhtml'><block type='go' x='10' y='40'></block></xml>"
    }
  }