{
  "mapInitState": {
    "board" : {
      "map" : [[2, 2, 2, 2, 2, 2, 2, 2],
      [2, 0, 2, 2, 2, 2, 2, 2],
      [2, 0, 0, 2, 2, 2, 2, 2],
      [2, 2, 0, 0, 2, 2, 2, 2],
      [2, 2, 2, 0, 0, 2, 2, 2],
      [2, 2, 2, 2, 0, 0, 2, 2],
      [2, 2, 2, 2, 2, 1, 2, 2],
      [2, 2, 2, 2, 2, 2, 2, 2]]
    },
    "character" : {
      "pos" : { "x" : 1, "y" : 1},
      "dir" : 2
    }
  },
  "mapResource": {
    "width": 8,
    "height": 8,
    "id": [ 
            122, 123, 123, 124, 123, 123, 124, 125,
            138, 140, 140, 140, 140, 156, 140, 141,
            138, 140, 140, 140, 140, 140, 140, 157,
            154, 140, 140, 140, 140, 140, 140, 157,
            154, 139, 140, 140, 140, 27, 140, 141,
            138, 155, 140, 155, 140, 140, 140, 157,
            138, 140, 140, 140, 140, 140, 140, 141,
            170, 171, 172, 172, 171, 171, 172, 173
          ],
    "id_t": [
              183, 183, 183, 183, 183, 183, 183, 183,
              183, 55, 183, 183, 183, 183, 183, 183,
              183, 71, 56, 183, 183, 183, 183, 183,
              183, 183, 72, 56, 183, 183, 183, 183,
              183, 183, 183, 72, 56, 63, 183, 183, 
              183, 183, 183, 183, 72, 57, 183, 183,
              183, 183, 183, 183, 183, 73, 183, 183,
              183, 183, 183, 183, 183, 183, 183, 183
            ]
  },
  "blocklyConfig": {
    "initialXml": "<xml xmlns='http://www.w3.org/1999/xhtml'><block type='actions_go' x='10' y='40'></block></xml>"
  }
}