{
  "mapInitState": {
    "board" : {
      "map" : [[0, 2, 2, 2, 0, 0, 0, 0],
      [0, 0, 0, 2, 0, 0, 0, 0],
      [0, 0, 0, 2, 0, 0, 0, 0],
      [0, 0, 0, 0, 0, 2, 0, 0],
      [0, 0, 0, 0, 2, 0, 0, 0],
      [0, 2, 0, 2, 0, 0, 0, 0],
      [0, 0, 0, 0, 0, 0, 1, 0],
      [0, 0, 0, 0, 0, 0, 0, 0]]
    },
    "character" : {
      "pos" : { "x" : 1, "y" : 1},
      "dir" : 2
		},
		"enemy" :["enemy1"],
		"enemy1" : {
			"pos" : { "x" : 7, "y" : 4},
			"dir" : 3,
			"isAlive" : true,
			"turningPoint" : [
				{
					"pos" : { "x" : 7, "y" : 1},
					"dir" : 1
				},
				{
					"pos" : { "x" : 7, "y" : 4},
					"dir" : 3
				}
			]
		}
  },
  "mapResource": {
    "width": 8,
    "height": 8,
    "id": [ 
            0, 1, 2, 3, 1, 2, 1, 4,
            16, 5, 6, 50, 50, 50, 50, 20,
            32, 21, 22, 50, 50, 50, 50, 36,
            48, 49, 50, 50, 50, 50, 50, 52,
            48, 51, 50, 50, 50, 50, 50, 52,
            48, 49, 50, 50, 50, 50, 50, 52,
            16, 50, 50, 50, 49, 50, 50, 52,
            64, 65, 66, 67, 67, 65, 65, 68
          ],
    "id_t": [
              183, 77, 110, 79, 183, 183, 183, 183, 
              183, 183, 183, 95, 183, 183, 183, 183, 
              183, 183, 183, 95, 183, 183, 183, 183, 
              183, 183, 34, 183, 183, 115, 183, 130, 
              183, 183, 183, 183, 115, 183, 183, 183, 
              183, 115, 183, 115, 183, 183, 183, 183, 
              183, 183, 228, 183, 183, 183, 114, 183, 
              183, 183, 183, 183, 183, 183, 183, 183
            ]
  },
  "blocklyConfig": {
    "initialXml": "<xml xmlns='http://www.w3.org/1999/xhtml'><block type='actions_go' x='10' y='40'></block></xml>"
  }
}