{
    "mapInitState": {
      "board" : {
        "map" : [[0, 94, 0, 94, 90, 0, 0, 94],
        [0, 94, 0, 94, 0, 0, 0, 94],
        [0, 94, 0, 94, 0, 0, 0, 94],
        [0, 0, 0, 94, 0, 95, 0, 94],
        [0, 0, 0, 0, 0, 0, 0, 0],
        [0, 92, 0, 0, 0, 0, 0, 0],
        [94, 94, 94, 94, 94, 94, 0, 94],
        [0, 0, 0, 94, 0, 0, 0, 0]],
        "torchPos" : { "x" : -1, "y" : -1},
        "bombPos" : {"x" : -1, "y" : -1},
        "bombArea" : []
      },
      "character" : {
        "pos" : { "x" : 7, "y" : 0},
        "dir" : 2,
        "items" : {
          "torchNum" : 2,
          "bombNum" : 1
        }
      },
      "enemy" :[{
        "pos" : { "x" : 5, "y" : 4},
        "dir" : 1,
        "status" : "alive",
        "turningPoint" : [
          {
            "pos" : { "x" : 5, "y" : 7},
            "dir" : 3
          },
          {
            "pos" : { "x" : 5, "y" : 4},
            "dir" : 1
          }
        ]
      }]
    },
    "mapResource": {
      "width": 8,
      "height": 8,
      "id": [
              0, 1, 2, 3, 1, 2, 1, 4,
              16, 50, 50, 50, 50, 50, 50, 36,
              48, 50, 50, 50, 50, 50, 50, 52,
              32, 50, 50, 50, 50, 50, 50, 52,
              32, 50, 50, 50, 50, 50, 50, 52,
              32, 50, 50, 50, 50, 50, 50, 36,
              48, 50, 50, 50, 50, 50, 50, 52,
              64, 67, 67, 65, 67, 65, 67, 68
            ],
      "id_t": [
                183, 95, 183, 95, 183, 183, 180, 95,
                183, 95, 183, 95, 183, 183, 183, 95,
                183, 95, 183, 95, 183, 183, 183, 95,
                183, 244, 183, 95, 183, 33, 183, 95,
                183, 183, 183, 183, 183, 183, 183, 183,
                183, 115, 183, 183, 131, 183, 183, 183,
                77, 110, 110, 110, 110, 110, 130, 111,
                183, 183, 183, 115, 183, 183, 183, 183
              ]
    },
    "blocklyConfig": {
      "initialXml": "<xml xmlns='http://www.w3.org/1999/xhtml'><block type='actions_go' x='10' y='40'></block></xml>"
    },
    "savedSolution":"",
    "stdBlockNum": 10
  }
