{
    "mapInitState": {
      "board" : {
        "map" : [[0, 0, 0, 0, 0, 0, 0, 0],
        [0, 0, 0, 0, 0, 0, 0, 0],
        [0, 0, 0, 0, 0, 0, 0, 0],
        [0, 0, 0, 0, 0, 0, 0, 0],
        [0, 0, 0, 0, 0, 0, 0, 0],
        [0, 0, 0, 0, 0, 0, 0, 0],
        [0, 0, 0, 0, 0, 0, 0, 0],
        [0, 0, 0, 0, 0, 0, 0, 0]]
      },
      "character" : {
        "pos" : { "x" : 7, "y" : 0},
        "dir" : 2
      },
      "enemy" :["enemy1"],
      "enemy1" : {
        "pos" : { "x" : 5, "y" : 4},
        "dir" : 1,
        "isAlive" : true,
        "turningPoint" : [
          {
            "pos" : { "x" : 5, "y" : 7},
            "dir" : 3
          },
          {
            "pos" : { "x" : 5, "y" : 4},
            "dir" : 1
          }
        ]
      }
    },
    "mapResource": {
      "width": 8,
      "height": 8,
      "id": [ 
              0, 1, 2, 3, 1, 2, 1, 4,
              16, 50, 50, 50, 50, 50, 50, 36,
              48, 50, 50, 50, 50, 50, 50, 52,
              32, 50, 50, 50, 50, 50, 50, 52,
              32, 50, 50, 50, 50, 50, 50, 52,
              32, 50, 50, 50, 50, 50, 50, 36,
              48, 50, 50, 50, 50, 50, 50, 52,
              64, 67, 67, 65, 67, 65, 67, 68
            ],
      "id_t": [
                183, 95, 183, 95, 114, 183, 180, 95, 
                183, 95, 183, 95, 183, 183, 228, 95, 
                183, 95, 183, 95, 183, 183, 183, 95, 
                183, 244, 183, 95, 183, 33, 183, 95, 
                183, 183, 183, 183, 183, 183, 183, 183, 
                183, 115, 183, 183, 131, 183, 183, 183, 
                77, 110, 110, 110, 110, 110, 130, 111,
                183, 183, 183, 115, 183, 183, 183, 183
              ]
    },
    "blocklyConfig": {
      "initialXml": "<xml xmlns='http://www.w3.org/1999/xhtml'><block type='go' x='10' y='40'></block></xml>"
    }
  }